wwwwwwwwwwwwwwwwwwwwwwwwww
w----x--w--A-------w-----w
w-------w----------w-x---w
wx------w----------www---w
w------------------------w
w----w--x----------------w
w----wwwwwwwwww----------w
w-------------w----------w
w-x-----------w---wwwwww-w
w----------x--w---x--w-x-w
w-------------w------w---w
wx---------e--w------x---w
wwwwwwwwwwwwwwwwwwwwwwwwww