wwwwwwwwwwwwwwwwwwwwwwwwww
w---------A--------------w
w-------w----w-----------w
w-------w----w-----------w
w-wwwwwww----wwwwwwwwwww-w
w-------w----w-----------w
wwwwww--w----w-----------w
w-------w----w-----------w
w--wwwwww----w-----------w
w--w----w----w-----------w
w--w--w-wwwwww-----------w
w-----w--e---------------w
wwwwwwwwwwwwwwwwwwwwwwwwww